========================================================================================
              |                                                    |______
      /|      |                                                    |      |\  
     / |      |                                                    |  3F  | \
    /  |      |                         __                         |______|  \
   /   |      |                      __/__\__                      |      |   \
  /    |      |                  ___/________\___                  |      |    \
 /   | |      |               __/________________\__               |      |     \
|    | |      |             _/______________________\_             |      |      |
|  | | |      |         ___/__________________________\___         |      |\     |
|  | |/|      |        /                                  \        |      | \    |
|  /  O|      |   ____/____________________________________\____   |      |  |   |
| /    |      |  /                                              \  |      |\ |   |
|    |\|      |_/________________________________________________\_|      | \|   |
|  /|| |                                                                  |      |
| / |  |                                                                  |      |
|     /                                                                    \     |
|    /                                                                      \    |
|   /                                                                        \   |
|  /                                                                          \  |
| /                                                                            \ |
|/                                                                              \|
========================================================================================
